        ############
        #     X  O #
        #   P   ##########
        #             X O#
        #######     ######
        #  O ##     #
########     ##     #
#                   #
#########  X   X    #
        #      O   ##
        ############
