###################
#                P#
#                 #
#     O  X        #
#                 #
#     X           #
#            X    #
#                 #
#       X    O    #
#                 #
#                 #
###################
